010000000000000000000000000000
010001111100001111100000011100
011111000010001000000111110100
001001111111111000111100000110
001000011000001111100110000000
001000001101110000100011011100
001000100111011000111001110110
001100110000001000001000010000
000110011110001011110000010100
000010000010111110011000010100
001111000011101000001100010100
001001100110001000000100011100
001100111100001100000110000100
000000100111100111000011000100
001111110000000001000001101100
000000010011100001110100110110
000111111010111010010100010010
001100001110001110011111111110
000001111000001000000100010010
000000000000000000000000000010

